111111111111
100000000001
10000P001111
100000000001
111110000001
100C00000001
1000110C0001
100000000001
11100C000001
111111101111
1E0000000001
111111111111