111111111111
100001000001
10001P101111
100000000001
111110000001
100C00000001
1000111C1001
100000010001
100000010001
100000010001
100000010001
100000010001
100000010001
100000010001
100000010001
100000010001
100000010001
100000010001
100000010001
100000010001
100000010001
100000010001
100000010001
100000010001
100000010001
100000010001
100000010001
100000010001
100000010001
100000010001
100000010001
100000010001
100000010001
100000010001
100000010001
100000010001
100000010001
100000010001
100000010001
100000010001
100000010001
100000010001
100000010001
100000010001
100000010001
100000010001
100000010001
100000010001
100000010001
100000010001
100000010001
100000010001
100000010001
100000010001
100000010001
100000010001
100000010001
100000010001
100000010001
100000010001
100000010001
100000010001
100000010001
100000010001
100000010001
100000010001
100000010001
100000010001
100000010001
100000010001
100000010001
100000010001
100000010001
100000010001
100000010001
100000010001
100000010001
100000010001
100000010001
100000010001
100000010001
100000010001
100000010001
100000010001
100000010001
100000010001
100000010001
100000010001
100000010001
100000010001
100000010001
100000010001
100000010001
100000010001
100000010001
100000010001
100000010001
100000010001
100000010001
100000010001
100000010001
100000010001
100000010001
100000010001
100000010001
100000010001
100000010001
100000010001
100000010001
100000010001
100000010001
100000010001
100000010001
100000010001
100000010001
100000010001
100000010001
100000010001
100000010001
100000010001
100000010001
100000010001
100000010001
100000010001
100000010001
100000010001
100000010001
100000010001
100000010001
100000010001
100000010001
100000010001
100000010001
100000010001
100000010001
100000010001
100000010001
100000010001
100000010001
100000010001
100000010001
100000010001
100000010001
100000010001
100000010001
100000010001
100000010001
100000010001
100000010001
100000010001
100000010001
100000010001
100000010001
100000010001
100000010001
100000010001
100000010001
100000010001
100000010001
100000010001
100000010001
100000010001
100000010001
100000010001
100000010001
100000010001
100000010001
100000010001
100000010001
100000010001
100000010001
100000010001
100000010001
100000010001
100000010001
100000010001
100000010001
100000010001
100000010001
100000010001
100000010001
100000010001
100000010001
100000010001
100000010001
100000010001
100000010001
100000010001
100000010001
100000010001
100000010001
100000010001
100000010001
100000010001
100000010001
100000010001
100000010001
100000010001
100000010001
100000010001
100000010001
100000010001
100000010001
100000010001
100000010001
100000010001
100000010001
100000010001
100000010001
100000010001
100000010001
100000010001
100000010001
100000010001
100000010001
100000010001
100000010001
100000010001
100000010001
100000010001
100000010001
100000010001
100000010001
100000010001
100000010001
100000010001
100000010001
100000010001
100000010001
100000010001
100000010001
100000010001
100000010001
100000010001
100000010001
100000010001
100000010001
100000010001
100000010001
100000010001
100000010001
100000010001
100000010001
100000010001
100000010001
100000010001
100000010001
100000010001
100000010001
100000010001
100000010001
100000010001
100000010001
100000010001
100000010001
100000010001
100000010001
100000010001
100000010001
100000010001
100000010001
100000010001
100000010001
100000010001
100000010001
100000010001
100000010001
100000010001
100000010001
100000010001
100000010001
100000010001
100000010001
100000010001
100000010001
100000010001
100000010001
100000010001
100000010001
100000010001
100000010001
100000010001
100000010001
100000010001
100000010001
100000010001
100000010001
100000010001
100000010001
100000010001
100000010001
100000010001
100000010001
100000010001
100000010001
100000010001
100000010001
100000010001
100000010001
100000010001
100000010001
100000010001
100000010001
100000010001
100000010001
100000010001
100000010001
100000010001
100000010001
100000010001
100000010001
100000010001
100000010001
100000010001
100000010001
100000010001
100000010001
100000010001
100000010001
100000010001
100000010001
100000010001
100000010001
100000010001
100000010001
100000010001
100000010001
100000010001
100000010001
100000010001
100000010001
100000010001
100000010001
100000010001
100000010001
100000010001
100000010001
100000010001
100000010001
100000010001
100000010001
100000010001
100000010001
100000010001
100000010001
100000010001
100000010001
100000010001
100000010001
100000010001
100000010001
100000010001
100000010001
100000010001
100000010001
100000010001
100000010001
100000010001
100000010001
100000010001
100000010001
100000010001
100000010001
100000010001
100000010001
100000010001
100000010001
100000010001
100000010001
100000010001
100000010001
100000010001
100000010001
100000010001
100000010001
100000010001
100000010001
100000010001
100000010001
100000010001
100000010001
100000010001
100000010001
100000010001
100000010001
100000010001
100000010001
100000010001
100000010001
100000010001
100000010001
100000010001
100000010001
100000010001
100000010001
100000010001
100000010001
100000010001
100000010001
100000010001
100000010001
100000010001
100000010001
100000010001
100000010001
100000010001
100000010001
100000010001
100000010001
100000010001
100000010001
100000010001
100000010001
100000010001
100000010001
100000010001
100000010001
100000010001
100000010001
100000010001
100000010001
100000010001
100000010001
100000010001
100000010001
100000010001
100000010001
100000010001
100000010001
100000010001
100000010001
100000010001
100000010001
100000010001
100000010001
100000010001
100000010001
100000010001
100000010001
100000010001
100000010001
100000010001
100000010001
100000010001
100000010001
100000010001
100000010001
100000010001
100000010001
100000010001
100000010001
100000010001
100000010001
100000010001
100000010001
100000010001
100000010001
100000010001
100000010001
100000010001
100000010001
100000010001
100000010001
100000010001
100000010001
100000010001
100000010001
100000010001
100000010001
100000010001
100000010001
100000010001
100000010001
100000010001
100000010001
100000010001
100000010001
100000010001
100000010001
100000010001
100000010001
100000010001
100000010001
100000010001
100000010001
100000010001
100000010001
100000010001
100000010001
100000010001
100000010001
100000010001
100000010001
100000010001
100000010001
100000010001
100000010001
100000010001
100000010001
100000010001
100000010001
100000010001
100000010001
100000010001
100000010001
100000010001
100000010001
100000010001
100000010001
100000010001
100000010001
100000010001
100000010001
100000010001
100000010001
100000010001
100000010001
100000010001
100000010001
100000010001
100000010001
100000010001
100000010001
100000010001
100000010001
100000010001
100000010001
100000010001
100000010001
100000010001
100000010001
100000010001
100000010001
100000010001
100000000001
100000010001
100000010001
100000010001
111111111011
10E000000001
111111111111