111111111111
100001000001
10001P101111
100000000001
111110000001
101C10000001
1010111C1001
100000000001
100000E10001
111111111011
100000000001
111111111111